8 . o X
........
..o.....
..o.....
..o.....
oooooooo
.....o..
.....o..
.....o..

