7 . o X
.o......
.o......
.o......
........
........
......o.
......o.

